SOURCE_CITY     DESTINATION_CITY        DURATION
CITY8               CITY3                   2
CITY8               CITY10                  3
CITY3               CITY1                   2
CITY3               CITY6                   1
CITY10              CITY11                  5
CITY1               CITY4                   3
CITY6               CITY4                   3
CITY6               CITY7                   2
CITY11              CITY5                   1
CITY11              CITY2                   4
SOURCE_CITY     DESTINATION_CITY        DURATION
