SOURCE_CITY     DESTINATION_CITY        DURATION
CITY1               CITY9                   1
CITY1               CITY2                   2
CITY9               CITY11                  5
CITY9               CITY6                   3
CITY2               CITY6                   4
CITY2               CITY5                   4
CITY11              CITY3                   3
CITY6               CITY4                   3
CITY5               CITY7                   4
CITY5               CITY10                  1
SOURCE_CITY     DESTINATION_CITY        DURATION
